p#r#.p.##...
.#.#...##..r
.m.###.m....
#.###r#.####
#.##....m.r#
#.E#.##r#m##
#.....##...X
#..r#..#..##
#####.#...m.
#..m.....#..
#r.#.###m#.p
#..m.#p..###

