#####r.#####
####.#m####r
##E#....mp#r
##.#m#..#...
##...#......
##p.#.......
r###m.#r###p
..##.###mX##
..r#.....###
##..m###m###
#pm.####r###
##....######

