#E..m.r#####
p#..####....
..m.#p##.##X
#.#r..#..#r.
###.#.#.##.#
##.m..m.##m#
pm.#...#...r
#..##..#m..r
##r###...#.#
#r###..###p#
..#.m.######
.....#######

